1111111111111111111111111
1000000000000000000000001
1000000100000000010000001
1000000000000001000000001
1000000001111000000000001
1000000000100000000000001
1000000000000000000100001
1000000000000010000000001
1001000000000010000000001
1001000000000011100000001
1111111111111111111111111