1111111111111111111111111
1000100000000000000010001
1000000000000000000000001
1000000000000000000000001
1000100000000000000000001
1000100000000000100000001
10001000000W0000100000001
1000000000000000000000001
1000000000000000000000001
1000000000000000000000001
1111111111111111111111111